16 8
1 2 3 4 0 6 7 8 9 10
1 2 3 4 5 0 7 8 9 10
1 2 3 4 5 6 0 8 9 10
1 2 3 4 5 6 7 0 9 10
1 2 3 4 5 6 7 8 0 10
1 2 3 4 5 6 7 8 9 0
0 0 0 0 0 0 0 0 0 0 
0 0 0 0 0 0 0 0 0 0
0 0 0 0 0 0 0 0 0 0 
0 0 0 0 0 0 0 0 0 0 
1 2 3 0 5 6 7 8 9 10
1 2 3 4 0 6 7 8 9 10
1 2 3 4 5 0 7 8 9 10
1 2 3 4 5 6 0 8 9 10
1 2 3 4 5 6 7 0 9 10
1 2 3 4 5 6 7 8 0 10
1 2 3 4 5 6 7 8 9 0